GRUPO 1
FABIO NONATO VIEIRA CERETO	fnvcereto@gmail.com
Giovani Fontes Viegas Henriques	ghenriques@id.uff.br
Marllon Oliveira Botelho Guida		marllon_oliveira@id.uff.br
Anderson Paixao dos Reis		eunota10@gmail.com

GRUPO 2
Victor Rodrigues Marques			victorrm@id.uff.br
VICTOR MATHEUS PEREIRA DE AZEVEDO	victorazevedo@id.uff.br
Gleison Lima de Souza			Gleisondop5@gmail.com
Christopher Albino Correa			christophercorrea@id.uff.br

GRUPO 3
Rafael Franca Scofield Lauar		rafavasco12@gmail.com
Lucas Greco Garcia Fernandes		lucasgreco@id.uff.br
Celso Contim			celso.contim@hotmail.com
Maycon Prata da Conceicao		mayconprata@id.uff.br
Pablo de Melo Manoel		pablomanoel@id.uff.br

GRUPO 4
Ana Luisa Azevedo Reveles Esposito	luisa_esposito@id.uff.br
Lucas Rogerio Silva Ferreira		lucasrogerio@id.uff.br
Samantha de Almeida Pereira Costa	samanthac@id.uff.br
Renan Henrique Ramalho Barbosa	re_henrique@id.uff.br

GRUPO 5
Fabiano do Nascimento Celestino	fcelestino@id.uff.br
Fabio Mateus Pereira Castro		fabio_castro@id.uff.br
Allan Patrick De Freitas Santana	allanpatrick@id.uff.br
Jorge da Silva Ribeiro junior		11157949738@gmail.com

GRUPO 6
Julia Figueiredo Simao Falcao		juliafsfalcao@hotmail.com
Henrique Fontenelle Teixeira		henriqueft@id.uff.br
VICTOR FREITAS			victorfreitas26@gmail.com
Wallace Ferreira Baleroni		wallacebaleroni@id.uff.br
Eduardo Busch Loivos		loivos713@gmail.com

GRUPO 7
PAUTERCIO RAMILSON OLIVEIRA DA SILVA	ramilson_silva@id.uff.br
AMANDA TAMIRES INACIO SILVA	amandainacio@id.uff.br
Lucas Ramalho dos Santos Ferreira	lucasrdsf@id.uff.br
RAFAEL HERBERT LIBORIO GOUVEIA	rafaelherbert.dev@gmail.com
Shaiana Zan Pereira			shaianazan@yahoo.com.br

GRUPO 8
Igor Rodrigues Lisboa	Igor_lisboa@id.uff.br
Caio Wey Barros		caiowey@id.uff.br
Felipe Cunha Sadoyama	felipesadoyama@id.uff.br
Daniel de Almeida Garrido	daniel_garrido@id.uff.br


